00000000000000000000
00000000000000000000
00000000000000000000
00000000000000000000
00000000000011000000
00000000020011000000
00000000020011000000
00000000000011000000
00000000000000000000
00000000000000000000
00000000000000000000
00000000000000000000
00000000000000000000
00000022000000000000
00000000000000000000
00000111100000000000
00000111100000000000
00000000000000000000
00000022000000000000
00000000000000000000