00000000000000001100
00000000000000201102
00000000000000001100
00000000000000000000
11100000000011000000
11100000020011002000
11100000020011002000
11100000000011000000
00000000000000000000
00000000000000000000
00000000000000000000
00000000000000000000
00000000000000000000
00000022000000222222
00000002000000222222
00000111100000220000
00000111100000220011
00000002000000220011
00000022000000000000
00000000000000000000